# Vocabulário de Estrangeirismos
# Esta base de pesquisa lexical abrange tão somente os vocábulos e expressões de origem estrangeira correntemente empregados no Brasil, com a grafia da língua de que provêm.
# URL: https://www.academia.org.br/nossa-lingua/vocabulario-de-estrangerismo (Consultado em 25 de jun de 2025)
# Palavra TAB Classes TAB Idioma
aardvark	s.m.	afr.
aardwolf	s.m.	afr.
ablaut	s.m.	al.
abstract	s.m.	ing.
accelerando	s.m. adv.	it.
accentus	s.m.	lat.
accordatura	s.f.	it.
ace	s.m.	ing.
affaire	s.m.	fr.
agrément	s.m.	fr.
aileron	s.m.	fr.
airbag	s.m.	ing.
allegretto	s.m.	it.
allegro	s.m. adv.	it.
alter ego	s.m.	lat.
alzheimer	s.m.	al.
angledozer	s.m.	ing.
anima	s.f.	lat.
anime	s.m.	jap.
animus	s.m.	lat.
anschauung	s.m.	al.
anschluss	s.m.	al.
antidoping	s.m.	ing.
antidumping	adj.2g.2n.	ing.
antispam	s.m.	ing.
apartheid	s.m.	ing.
apfelstrudel	s.m.	al.
aplomb	s.m.	fr.
apparatchik	s.m.	rus.
apparat	s.m.	rus.
appassionato	adj. s.m.	it.
appoggiatura	s.f.	it.
apport	s.m.	fr.
approach	s.m.	ing.
app	s.m.	ing.
apud	prep.	lat.
argot	s.m.	fr.
arpeggiatura	s.f.	it.
art déco	s.2g. adj.2g.2n.	fr.
art nouveau	s.2g. adj.2g.2n.	fr.
artsy	adj.2g.2n.	ing.
assemblage	s.f.	fr.
assembler	s.m.	ing.
atelier	s.m.	fr.
aufldärung	s.f.	al.
autocross	s.m.	ing.
avant-première	s.f.	fr.
ayurveda	s.m.	sâns.
ayurvédico	adj.	sâns.
baby-beef	s.m.	ing.
baby-doll	s.m.	ing.
baby-sitter	s.2g.	ing.
baby	s.m.	ing.
backbone	s.m.	ing.
backdrop	s.m.	ing.
backgammon	s.m.	ing.
background	s.m.	ing.
backhand	s.m.	ing.
backland	s.m.	ing.
backlight	s.m.	ing.
back	s.m.	ing.
backstage	s.m.	ing.
backup	s.m.	ing.
bacon	s.m.	ing.
badine	s.f.	fr.
badland	s.f.	ing.
badminton	s.m.	ing.
banana split	s.f.	ing.
band-aid	s.m.	ing.
banner	s.m.	ing.
barmaid	s.f.	ing.
barman	s.m.	ing.
bar-mitzvá	s.m.	hebr.
barn	s.m.	ing.
baseball	s.m.	ing.
bas-fond	s.m.	fr.
basketball	s.m.	ing.
bateau-mouche	s.m.	fr.
bauhaus	adj.2g.2n.	al.
bayeux	s.f.2n.	fr.
beagle	s.m.	ing.
beatnik	s.2g.	ing.
beige	adj.2g.2n. s.m.	fr.
benedictus	s.m.	lat.
berceuse	s.f.	fr.
bergère	s.f.	fr.
best-seller	s.m.	ing.
betting	s.m.	ing.
bias	s.m.	ing.
bidon	s.m.	fr.
big	adj.2g.2n.	ing.
bikini	s.m.	ing.
bill	s.m.	ing.
biofeedback	s.m.	ing.
bip	s.m.	ing.
biscuit	s.m.	fr.
biseauté	adj.	fr.
bise	s.f.	fr.
bisque	s.f.	fr.
bitcoin	s.2g.	ing.
bit	s.m.	ing.
bitter	s.m.	ing.
blackout	s.m.	ing.
black	s.m.	ing.
blague	s.f.	fr.
blanquette	s.f.	fr.
blasé	adj. s.m.	fr.
blazer	s.m.	ing.
blend	s.m.	ing.
blister	s.m.	ing.
blitzkrieg	s.f.	al.
blitz	s.f.	al.
blitze	s.f.pl	al.
blocause	s.2g.	al.
blocausse	s.2g.	al.
blockbuster	adj. s.m.	ing.
blockchain	s.2g.	ing.
blog	s.m.	ing.
blonde	s.m.	fr.
blowup	s.m.	ing.
blue	s.m.	ing.
blues	s.m.2n.	ing.
bluetooth	s.m.	ing.
bluff	s.m.	ing.
blush	s.m.	ing.
bob	s.m.	ing.
bodegón	s.m.	esp.
body-boarder	adj. s.2g.	ing.
body-board	s.m.	ing.
body shaming	s.m.	ing.
boho	adj.2g.2n.	ing.
boho-chic	adj.2g.2n. s.m.	ing.
boiler	s.m.	ing.
boîte	s.f.	fr.
bold	s.m.	ing.
bonbonnière	s.f.	fr.
bond	s.m.	ing.
bon-vivant	s.m.	fr.
boogie-woogie	s.m.	ing.
bookmaker	s.m.	ing.
boom	s.m.	ing.
booster	s.m.	ing.
boot	s.m.	ing.
bordeaux	s.m.	fr.
bordereau	s.m.	fr.
bort	s.m.	ing.
botox	s.m.	ing.
boudoir	s.m.	fr.
boulevard	s.m.	fr.
boulle	s.m.	fr.
bouquet	s.m.	fr.
bourbon	s.m.	fr.
bourrée	s.f.	fr.
boutade	s.f.	fr.
boutique	s.f.	fr.
boxeur	s.m.	fr.
box	s.m.	ing.
boy	s.m.	ing.
braciola	s.f.	it.
braille	adj.2g. s.m.	fr.
brandade	s.f.	fr.
brandy	s.m.	ing.
brasserie	s.f.	fr.
breakfast	s.m.	ing.
break	s.m.	ing.
bremsstrahlung	s.m.	al.
brevet	s.m.	fr.
bridge	s.m.	ing.
briefing	s.m.	ing.
brie	s.m.	fr.
brise-bise	s.m.	fr.
brise-soleil	s.m.	fr.
bris	s.m.	hebr.
broadcasting	s.m.	ing.
broadcast	s.m.	ing.
broadside	s.m.	ing.
brownie	s.m.	ing.
browning	s.m.	ing.
browser	s.m.	ing.
brunch	s.m.	ing.
brunette	s.f.	fr.
budget	s.m.	ing.
buffering	s.m.	ing.
buffer	s.m.	ing.
buffet	s.m.	fr.
bug	s.m.	ing.
bullying	s.m.	ing.
bunker	s.m.	ing.
bureau	s.m.	fr.
burlesque	s.m.	fr.
burnout	s.m.	ing.
burrata	s.f.	it.
busdoor	s.m.	ing.
bushido	s.m.	jap.
bushmen	s.m.pl.	ing.
bush	s.m.	ing.
businessman	s.m.	ing.
button	s.m.	ing.
bye-bye	s.m. interj.	ing.
by-pass	s.m.	ing.
byte	s.m.	ing.
cabaretier	s.m.	fr.
cab	s.m.	ing.
cache	s.m.	ing.
cake designer	s.2g.	ing.
cake design	s.m.	ing.
call girl	s.f.	ing.
call-girl	s.f.	ing.
calzone	s.m.	it.
camaïeu	s.m.	fr.
camber	s.m.	ing.
camembert	s.m.	fr.
cameraman	s.m.	ing.
campanile	s.m.	it.
camping	s.m.	ing.
campus	s.m.	lat.
caniche	s.m.	fr.
cantabile	adj. s.m.	it.
cantata	s.f.	it.
canyon	s.m.	ing.
cappuccino	s.m.	it.
caput	s.m.	lat.
cardan	s.m.	fr.
carnet	s.m.	fr.
carpaccio	s.m.	it.
càrpano	s.m.	it.
carrière	s.f.	fr.
carrying	s.m.	ing.
cartoon	s.m.	ing.
cashback	s.m.	ing.
cashmere	s.m.	ing.
cash	s.m.	ing.
cassoulet	s.m.	fr.
casting	s.m.	ing.
castrato	s.m.	it.
cast	s.m.	ing.
catch-as-catch-can	s.m.	ing.
catch	s.m.	ing.
catering	s.m.	ing.
cattivo	adj. s.m.	it.
caucus	s.m.	ing.
causerie	s.f.	fr.
causeur	s.m.	fr.
causeuse	s.f.	fr.
céladon	s.m.	fr.
celebret	s.m.	lat.
center-forward	s.m.	ing.
centum	num.	lat.
cerealia	s.m.	lat.
cermet	s.m.	ing.
chaclik	s.m.	rus.
chagrin	s.m.	fr.
chaise-longue	s.f.	fr.
chalá	s.f.	hebr.
chambertin	s.m.	fr.
champignon	s.m.	fr.
changeant	adj.	fr.
changer-de-dame	s.m.	fr.
changez-de-dame	s.m.	fr.
chantilly	s.m.	fr.
chanuca	s.f.	hebr.
chardonnay	s.m.	fr.
charge	s.f.	fr.
charleston	s.m.	ing.
charter	s.m.	ing.
chartreuse	s.f.	fr.
chasselás	s.f.	fr.
chatbot	s.m.	ing.
chateaubriand	s.m.	fr.
châtelaine	s.f.	fr.
chat	s.m.	ing.
chauffage	s.m.	fr.
chauffeur	s.m.	fr.
chazan	s.m.	hebr.
checking	s.m.	ing.
check-in	s.m.	ing.
checklist	s.2g.	ing.
check-out	s.m.	ing.
checkout	s.m.	ing.
check-up	s.m.	ing.
checkup	s.m.	ing.
cheddar	s.m.	ing.
cheeseburger	s.m.	ing.
cheesecake	s.f.	ing.
chef-d’oeuvre	s.m.	fr.
chef	s.m.	fr.
chemise	s.2g.	fr.
chemisier	adj.2g.2n. s.m.	fr.
cherry	s.m.	ing.
chester	s.m.	ing.
chez	prep.	fr.
chianti	s.m.	it.
chic	adj.2g. s.m.	fr.
chicano	adj. s.m.	esp.
chiffrier	s.m.	fr.
chihuahua	adj. s.2g.	esp.
chikungunya	adj. s.2g.	sua.
chimichurri	s.m.	esp.
chippendale	adj.2g. s.m.	ing.
chip	s.m.	ing.
chômamge	s.m.	fr.
chop-suey	s.m.	chin.
chow-chow	s.m.	ing.
chutney	s.m.	ing.
ciao	interj.	it.
cielito	s.m.	esp.
cinemascope	s.m.	ing.
cinquecento	s.m.	it.
cirrus	s.m.2n.	lat.
civet	s.m.	fr.
clearance	s.m.	ing.
clearing	s.m.	ing.
cliffhanger	s.m.	ing.
clipper	s.m.	ing.
clip	s.m.	ing.
cloche	s.f.	fr.
cloisonné	adj.	fr.
close-shot	s.m.	ing.
close	s.m.	ing.
closet	s.m.	ing.
close-up	s.m.	ing.
clou	s.m.	fr.
clown	s.m.	ing.
club	s.m.	ing.
clumber	adj. s.2g.	ing.
coaching	s.m.	ing.
coach	s.2g.	ing.
cocker spaniel	s.m.	ing.
cockpit	s.m.	ing.
cocktail	s.m.	ing.
cocotte	s.f.	fr.
cogito	s.m.	lat.
cognac	s.m.	fr.
collant	adj. s.m.	fr.
collie	s.m.	ing.
colón	s.m.	esp.
coloratura	adj. s.2g.	it.
colored	adj. s.2g.	ing.
colt	s.m.	ing.
commodity	s.f.	ing.
communard	s.f.	fr.
compact-disc	s.m.	ing.
compagnonnage	s.m.	fr.
complainte	s.f.	fr.
compliance	s.m.	ing.
complot	s.m.	fr.
comptoir	s.m.	fr.
comunero	s.m.	esp.
conarium	s.m.	lat.
concierge	s.2g.	fr.
condom	s.m.	ing.
condottiere	s.m.	it.
condottiero	s.m.	it.
conduíte	s.2g.	fr.
confiteor	s.m.	lat.
connaisseur	s.m.	fr.
consommé	s.m.	fr.
container	s.m.	ing.
conteur	s.m.	fr.
continuum	s.m.	lat.
cookie	s.m.	ing.
cooktop	s.m.	ing.
cooler	s.m.	ing.
copyright	s.m.	ing.
coquette	adj. s.f.	fr.
coquille	s.m.f.	fr.
corbeille	s.f.	fr.
cordon-bleu	s.m.	fr.
corned beef	s.m.	ing.
corner	s.m.	ing.
corpus	s.m.	lat.
cortile	s.m.	it.
cosnommé	s.m.	fr.
coterie	s.f.	fr.
côte-rôtie	s.f.	fr.
cotillon	s.m.	fr.
cotswold	s.m.	ing.
cottage	s.m.	ing.
couché	adj. s.m.	fr.
coudé	adj.	fr.
counter-card	s.m.	ing.
counter-display	s.m.	ing.
counterglow	s.m.	ing.
coup-de-foudre	s.m.	fr.
coup-de-grâce	s.m.	fr.
coup-de-main	s.m.	fr.
coup-de-maître	s.m.	fr.
coup-de-poing	s.m.	fr.
coup-d’état	s.m.	fr.
coup-de-théâtre	s.m.	fr.
coupé	adj. s.m.	fr.
couplet	s.m.	fr.
coupon	s.m.	fr.
court-bouillon	s.m.	fr.
couvade	s.f.	fr.
couvert	s.m.	fr.
covenant	s.m.	ing.
cover girl	s.f.	ing.
cowboy	s.m.	ing.
co-worker	s.2g.	ing.
coworker	s.2g.	ing.
co-working	s.m.	ing.
coworking	s.m.	ing.
cowpox	s.m.	ing.
coxsackie	s.m.	ing.
cracker	s.m.	ing.
cracking	s.m.	ing.
crack	s.m.	ing.
crapouillot	s.m.	fr.
crau	s.f.	fr.
craw-craw	s.m.	ing.
crawl	s.m.	ing.
crayon	s.m.	fr.
cream cheese	s.m.	ing.
crémant	adj. s.m.	fr.
crevasse	s.f.	fr.
criadilla	s.f.	esp.
cricket	s.m.	ing.
cri-du-chat	s.m.	fr.
criss-cross	s.m.	ing.
criterium	s.m.	lat.
croissant	s.m.	fr.
cromlech	s.m.	ing.
crooner	s.2g.	ing.
croquis	s.m.	fr.
croskill	s.m.	ing.
cross-country	s.m.	ing.
crossdresser	s.2g.	ing.
crossfit	s.m.	ing.
crossing-over	s.m.	ing.
cross-section	s.f.	ing.
croupier	s.m.	fr.
croupon	s.m.	fr.
croûte	s.f.	fr.
crowdfunding	s.m.	ing.
crowdlearning	s.m.	ing.
crown-glass	s.m.	ing.
crown	s.m.	ing.
crudités	s.f.pl.	fr.
cruelty-free	adj.2g.2n.	ing.
cruiser	s.m.	ing.
crux	s.f.	lat.
cueca	s.f.	esp.
cuesta	s.f.	esp.
cul-de-lampe	s.m.	fr.
cul-de-sac	s.m.	fr.
cult	adj.2g.2n.	ing.
curriculum	s.m.	lat.
curry	s.m.	ing.
cursus	s.m.	lat.
cyberbullying	s.m.	ing.
cyberpunk	s.m.	ing.
dachshund	s.m.	al.
dancing	s.m.	ing.
daruma	s.m.	jap.
dasein	s.m.	al.
datum	s.m.	lat.
deadline	s.m.	ing.
dealer	s.2g.	ing.
déboulé	s.m.	fr.
debriefing	s.m.	ing.
début	s.m.	fr.
debye	s.m.	ing.
deck	s.m.	ing.
décor	s.m.	fr.
découpage	s.m.	fr.
default	s.m.	ing.
deficit	s.m.2n.	lat.
dégagement	s.m.	fr.
dégagé	s.m.	fr.
dégradé	adj. s.m.	fr.
déjà-vu	s.m.	fr.
délavé	adj.	fr.
delay	s.m.	ing.
deleatur	s.m.	lat.
delikatessen	s.f.pl.	al.
delivery	s.f.	ing.
délivrance	s.f.	fr.
démanché	s.m.	fr.
démarche	s.f.	fr.
demi-monde	s.m.	fr.
demi-vierge	s.f.	fr.
démodé	adj.	fr.
denier	s.m.	fr.
denotatum	s.f.	lat.
derby	s.m.	ing.
derrick	s.m.	ing.
derroche	s.m.	esp.
desdichado	adj.	esp.
deshabillé	s.m.	fr.
desideratum	s.m.	lat.
designatum	s.m.	lat.
designer	s.2g.	ing.
design	s.m.	ing.
desktop	s.m.	ing.
détente	s.f.	fr.
detox	s.m.	ing.
détraqué	adj.2g. s.2g.	fr.
développé	s.m.	fr.
dewar	s.m.	ing.
diablerie	s.f.	fr.
dictum	s.m.	lat.
diesel	adj.2g. s.m.	ing.
diet	adj.2g.2n.	ing.
dime	s.m.	ing.
dimmer	s.m.	ing.
dirham	s.m.	ár.
disclaimer	s.m.	ing.
diseur	s.m.	fr.
diseuse	s.f.	fr.
display	s.m.	ing.
distemper	s.m.	ing.
divertissement	s.m.	fr.
dobermann	s.m.	al.
docar	s.m.	ing.
dogcart	s.m.	ing.
dog walker	s.m.	ing.
dojo	s.m.	jap.
dolce	adj.2g.	it.
dolcemente	adv.	it.
donjuán	s.m.	esp.
doping	s.m.	ing.
doppler	s.m.	ing.
dossier	s.m.	fr.
doublé	adj. s.m.	fr.
download	s.m.	ing.
downtime	s.m.	ing.
draft	s.m.	ing.
drag king	s.m.	ing.
drag queen	s.f.	ing.
drawback	s.m.	ing.
dreadlocks	s.m.pl.	ing.
dreadnought	s.m.	ing.
dread	s.m.	ing.
dress code	s.m.	ing.
drink	s.m.	ing.
drive-in	s.m.	ing.
driver	s.m.	ing.
drive	s.m.	ing.
drive-thru	s.m.	ing.
drone	s.m.	ing.
drops	s.m.2n.	ing.
drugstore	s.m.	ing.
drumlin	s.m.	ing.
dry	adj.2g.2n. s.m.	ing.
dry-farming	s.m.	ing.
duce	s.m.	it.
dumping	s.m.	ing.
durée	s.f.	fr.
e-book	s.m.	ing.
écarté	s.m.	fr.
ecce-homo	s.m.2n.	lat.
éclair	s.m.	fr.
e-commerce	s.m.	ing.
écran	s.m.	fr.
ecstasy	s.m.	ing.
edamame	s.m.	jap.
edam	s.m.	hol.
egrete	s.f.	fr.
élan	s.m.	fr.
elohim	s.m.	hebr.
elul	s.m.	hebr.
e-mail	s.m.	ing.
email	s.m.	ing.
emmenthal	s.m.	fr.
emoji	s.m.	jap.
emoticon	s.m.	ing.
endomarketing	s.m.	ing.
enjambement	s.m.	fr.
ensalada	s.f.	esp.
ensaladilla	s.f.	esp.
ensemble	s.m.	fr.
entente	s.f.	fr.
entourage	s.m.	fr.
entrechat	s.m.	fr.
entrecôte	s.m.	fr.
erg	s.m.	fr.
erratum	s.m.	lat.
ersatz	s.m.	al.
escargot	s.m.	fr.
establishment	s.m.	ing.
étagère	s.f.	fr.
ether	s.m.	ing.
expertise	s.f.	fr.
expert	s.2g.	fr.
extranet	s.f.	ing.
eyelinner	s.m.	ing.
factoring	s.m.	ing.
fade-in	s.m.	ing.
fade-out	s.m.	ing.
fade	s.m.	ing.
fading	s.m.	ing.
faille	s.f.	fr.
fairway	s.m.	ing.
faisandé	adj.	fr.
fake news	s.f.pl.	ing.
fanfreluche	s.f.	fr.
faraday	s.m.	ing.
farad	s.m.	ing.
fashion	adj.2g.2n.	ing.
fast-food	s.f.	ing.
fast food	s.f. s.m.	ing.
fauteuil	s.m.	fr.
favicon	s.m.	ing.
fedayin	s.m.	ár.
feedback	s.m.	ing.
feeder	s.m.	ing.
feeling	s.m.	ing.
féerie	s.f.	fr.
fermata	s.f.	it.
ferryboat	s.m.	ing.
fettuccine	s.m.2n.	it.
ficelle	s.f.	fr.
fil-à-fil	s.m.	fr.
filet	s.m.	fr.
finesse	s.f.	fr.
fintech	s.f.	ing.
firewall	s.m.	ing.
fitness	sm.2n.	ing.
flamberge	s.f.	fr.
flamboyant	adj. s.m.	fr.
flan	s.m.	fr.
flap	s.m.	ing.
flashback	s.m.	ing.
flash	s.m.	ing.
flat	s.m.	ing.
flint-glass	s.m.	ing.
flip-flop	s.m.2n.	ing.
flip	s.m.	ing.
flirt	s.m.	ing.
flou	adj. s.2g.	fr.
flush	s.m.	ing.
flûte	s.f.	fr.
flutter	s.m.	ing.
flyback	s.m.	ing.
fog	s.m.	ing.
folium	s.m.	lat.
fondant	s.m.	fr.
fonda	s.f.	esp.
fondue	s.f.	fr.
fontange	s.f.	fr.
footing	s.m.	ing.
foot	s.m.	ing.
foramina	s.m.pl.	lat.
forfait	s.m.	fr.
fortran	s.m.	ing.
forward	adv.	ing.
foulard	s.m.	fr.
foul	s.m.	ing.
fourrure	s.f.	fr.
four	s.m.	ing.
fox-blue	s.m.	ing.
foxhound	s.m.	ing.
foyer	s.m.	fr.
frame	s.m.	ing.
franchise	s.f.	ing.
franchising	s.f.	ing.
frappé	adj.	fr.
free-lance	adj.2g. s.m.	ing.
free-lancer	adj. s.2g.	ing.
freeware	s.m.	ing.
freezer	s.m.	ing.
frisson	s.m.	fr.
frizz	s.m.	ing.
front	s.m.	fr.
fugato	s.m.	it.
fumoir	s.m.	fr.
funk	s.m.	ing.
fusain	s.m.	fr.
fuseau	s.m.	fr.
futon	s.m.	jap.
gadget	s.m.	ing.
gag	s.f.	ing.
gaijin	s.m.pl.	jap.
galuchat	s.m.	fr.
game	s.m.	ing.
gang	s.f.	ing.
gap	s.m.	ing.
garage	s.f.	fr.
garamond	s.m.	fr.
garçonnière	s.f.	fr.
garden-party	s.m.	ing.
gaslighting	s.m.	ing.
gauche	adj. s.2g.	fr.
gauleiter	s.m.	al.
gay	adj. s.2g.	ing.
geek	adj. s.2g.	ing.
gefite fish	s.m.	iíd.
gentleman	s.m.	ing.
gestalt	s.f.	al.
getter	s.m.	ing.
geyser	s.m.	ing.
ghost-writer	s.2g.	ing.
gigabit	s.m.	ing.
gigabyte	s.m.	ing.
girl	s.f.	ing.
glacis	s.m.	fr.
glamour	s.m.	ing.
glasnost	s.m.	rus.
glide	s.m.	ing.
globe-trotter	s.m.	ing.
gnocchi	s.m.	it.
goalball	s.m.	ing.
goalkeeper	s.m.	ing.
goal	s.m.	ing.
gobelet	s.m.	fr.
gobelin	adj.2g. s.m.	fr.
golf	s.m.	ing.
gordon	s.m.	ing.
gospel	s.m.	ing.
gouda	s.m.	hol.
gourmand	s.m.	fr.
gourmet	s.2g. adj.2g.2n.	fr.
goy	s.2g.	hebr.
gradatim	adv.	lat.
grand-guignol	s.m.	fr.
grapefruit	s.m.	ing.
gray	s.m.	ing.
green	s.m.	ing.
greenwashing	s.m.	ing.
greisen	s.m.	al.
grenadine	s.f.	fr.
grenat	adj.2g.2n. s.m.	fr.
greyhound	s.m.	ing.
grid	s.m.	ing.
grillroom	s.m.	ing.
grill	s.m.	ing.
groom	s.m.	ing.
gros-grain	s.m.	fr.
ground	s.m.	ing.
groupie	s.2g.	ing.
gruyère	adj.2g. s.m.	fr.
guipure	s.f.	fr.
gulag	s.m.	rus.
habadin	s.2g.2n.	hebr.
habanera	s.f.	esp.
habeas corpus	s.m.	lat.
habillé	adj.	fr.
habitat	s.m.2n.	lat.
habitué	adj. s.m.	fr.
habitus	s.m.2n.	lat.
hacienda	s.f.	esp.
hacker	s.2g.	ing.
hack	s.m.	ing.
haddock	s.m.	ing.
hadith	s.m.	ár.
hagadá	s.f.	hebr.
haikai	s.m.	jap.
hair stylist	s.2g.	ing.
half-back	s.m.	ing.
halle	s.f.	fr.
halloween	s.m.	ing.
hall	s.m.	ing.
hamster	s.m.	ing.
hamus	s.m.2n.	ár.
handball	s.m.	ing.
handbike	s.f. s.m.	ing.
handcycle	s.f. s.m.	ing.
handicap	s.m.	ing.
hanukah	s.m.	hebr.
happening	s.m.	ing.
happy hour	s.m.	ing.
hard	adj.	ing.
hardcore	s.m.	ing.
hardware	s.m.	ing.
harrier	s.m.	ing.
hartley	s.m.	ing.
hashtag	s.f.	ing.
hater	s.2g.	ing.
hat trick	s.m.	ing.
hat-trick	s.m.	ing.
haute-gomme	s.f.	fr.
hazkarah	s.f.	hebr.
headhunter	s.m.	ing.
headphone	s.m.	ing.
hédge	s.m.	ing.
hélas	interj.	fr.
hereford	adj. s.2g.2n.	ing.
hi-fi	s.m.	ing.
highline	s.m.	ing.
high-tech	s.m.	ing.
hinterland	s.m.	al.
hiperlink	s.m.	ing.
hip-hop	s.m.2n.	ing.
hip	interj.	ing.
hippie	adj. s.2g.	ing.
hippie-chic	adj.2g.2n.	ing.
hipster	adj.2g.2n. s.m.	ing.
hit	s.m.	ing.
hobby	s.m.	ing.
hockey	s.m.	ing.
holding	s.f.	ing.
holter	s.m.	ing.
home banking	s.m.	ing.
home office	s.m.	ing.
home page	s.f.	ing.
homepage	s.f.	ing.
home theater	s.m.	ing.
homo	s.m.	lat.
homus	s.m.2n.	ár.
hooligan	s.m.	ing.
hornpipe	s.m.	ing.
hors-concours	adj. s.2n.	fr.
hors-d’oeuvre	s.m.2n.	fr.
horsepower	s.m.	ing.
hors-ligne	adj.2g.2n.	fr.
hostel	s.m.	ing.
hostess	s.f.	ing.
host	s.m.	ing.
hot	adj.	ing.
hot dog	s.m.	ing.
hovercraft	s.m.	ing.
huaca	s.f.	esp.
huapango	s.m.	esp.
huérfago	s.m.	esp.
humoresque	s.f.	fr.
humour	s.m.	ing.
husky	s.m.	ing.
hybris	s.f.	gr.
hydrofoil	s.m.	ing.
hyperlink	s.m.	ing.
ibidem	adv.	lat.
iceberg	s.m.	ing.
idem	pron.	lat.
id	s.m.	lat.
ikebana	s.f.	jap.
impeachment	s.m.	ing.
impedimenta	s.m.pl.	lat.
imperator	s.m.	lat.
impériale	s.f.	fr.
impromptu	s.m.	fr.
incipit	s.m.	lat.
incontinenti	adv.	lat.
indie	adj.2g.2n. s.2g. s.m.	ing.
indoor	adj.2g.2n. s.m.	ing.
infectum	s.m.	lat.
infinitum	s.m.	lat.
influenza	s.f.	it.
in-octavo	s.m.	lat.
input	s.m.	ing.
inro	s.m.	jap.
insight	s.m.	ing.
intaglio	s.m.	it.
intelligentsia	s.f.	rus.
intercapedo	s.f.	lat.
intermezzo	s.m.	it.
internet banking	s.m.	ing.
internet	s.f.	ing.
inter	prep.	lat.
interview	s.m.	ing.
intranet	s.f.	ing.
intruder	s.m.	ing.
ipso facto	adv.	lat.
isospin	s.m.	ing.
item	adv.	lat.
it girl	s.f.	ing.
it	s.m.	ing.
jack	s.m.	ing.
jacquard	s.m.	fr.
jacquerie	s.f.	fr.
jaen	s.m.	esp.
jam session	s.m.	ing.
jazz-band	s.m.	ing.
jazzman	s.m.	ing.
jazz	s.m.	ing.
jeans	s.m.2n.	ing.
jenny	s.f.	ing.
jet leg	s.m.	ing.
jeton	s.m.	fr.
jet set	s.m.	ing.
jeu-de-mots	s.m.	fr.
jihad	s.m.	ár.
jingle	s.m.	ing.
jin	s.m.pl.	ár.
job	s.m.	ing.
jodel	s.m.	al.
jogger	s.2g.	ing.
jogging	s.m.	ing.
joruri	s.m.	jap.
jota	s.f.	esp.
joystick	s.m.	ing.
jube domine	s.m.	lat.
judica	s.m.	lat.
jumpline	s.m.	ing.
juste-milieu	s.m.	fr.
kacher	adj.2g.2n.	hebr.
kadisch	s.m.	aram.
kadosh	s.m.	hebr.
kaiser	s.m.	al.
kakuro	s.m.	jap.
kana	s.m.	jap.
karaoke	s.m.	jap.
karma	s.m.	sâns.
karting	s.m.	ing.
kart	s.m.	ing.
kashrut	s.f.	hebr.
kefir	s.m.	rus.
kelpie	s.m.	ing.
kernicterus	s.m.	lat.
kersey	s.m.	ing.
ketchup	s.m.	ing.
keuper	s.m.	al.
kibutz	s.m.	hebr.
kilobit	s.m.	ing.
kilobyte	s.m.	ing.
kilt	s.m.	ing.
king	s.m.	ing.
kirsch	s.m.	al.
kitesurf	s.m.	ing.
kitsch	adj.2g. s.2n.	al.
kit	s.m.	ing.
kiwi	s.m.	ing.
kjökkenmödding	s.m.	din.
klaxon	s.m.	ing.
knockout	s.m.	ing.
know-how	s.m.	ing.
koiné	s.f.	gr.
kombucha	s.2g.	jap.
kosher	adj.2g.2n.	iíd.
kümmel	s.m.	al.
kyogen	s.m.	jap.
lacrima-christi	s.m.	lat.
lady	s.f.	ing.
laika	s.2g.	rus.
laissez-aller	s.m.2n.	fr.
laissez-faire	sm.2n.	fr.
laissez-passer	s.m.	fr.
lambert	s.m.	ing.
laptop	s.m.	ing.
larghetto	s.m.	it.
laser	s.m.	ing.
lavallière	s.f.	fr.
layoutman	s.m.	ing.
layout	s.m.	ing.
leader	s.m.	ing.
lead	s.m.	ing.
leasing	s.m.	ing.
leave-in	s.m.	ing.
legato	adj. s.m.	it.
liard	s.m.	fr.
lied	s.m.	al.
lifestyle	s.m.	ing.
liftvan	s.m.	ing.
light	adj.2g.2n.	ing.
limaçon	s.m.	fr.
limes	s.m.	lat.
lingerie	s.f.	fr.
link	s.m.	ing.
liptak	s.m.	esl.
liseuse	s.f.	fr.
live-action	adj.2g.2n.	ing.
live	s.f.	ing.
living	s.m.	ing.
llano	s.m.	esp.
load	s.m.	ing.
lobby	s.m.	ing.
lob	s.m.	ing.
lockdown	s.m.	ing.
lockout	s.m.	ing.
locus	s.m.	lat.
loft	s.m.	ing.
loggia	s.f.	it.
loghouse	s.f.	ing.
log-in	s.m.	ing.
login	s.m.	ing.
log-off	s.m.	ing.
logoff	s.m.	ing.
log-on	s.m.	ing.
logon	s.m.	ing.
log-out	s.m.	ing.
logout	s.m.	ing.
longline	s.m.	ing.
long-playing	adj. s.m.	ing.
long-play	s.m.	ing.
looping	s.m.	ing.
loop	s.m.	ing.
loran	s.m.	ing.
lorgnon	s.m.	fr.
löss	s.m.	al.
lotta	s.f.	fin.
lounge	adj.2g.2n. s.m.	ing.
loure	s.f.	fr.
louré	s.m.	fr.
lunik	s.m.	rus.
luthier	s.m.	fr.
macaron	s.m.	fr.
mackintosh	s.m.	ing.
madeleine	s.f.	fr.
mademoiselle	s.f.	fr.
maestoso	adj. adv.	it.
magnificat	s.m.	lat.
maharishi	s.m.	sâns.
mahatma	s.m.	sâns.
mainstream	adj.2g.2n. s.m.	ing.
maître	s.m.	fr.
make-up	s.2g.	ing.
making-of	s.m.	ing.
malware	s.m.	ing.
mambo	s.m.	esp.
management	s.m.	ing.
manager	s.2g.	ing.
manoir	s.m.	fr.
manucure	s.f.	fr.
marchand	s.2g.	fr.
marginalia	s.m.pl.	lat.
mariachi	s.m.	esp.
marketing	s.m.	ing.
marketplace	s.m.	ing.
marshmallow	s.m.	ing.
martenot	s.m.	fr.
master class	s.f.	ing.
masterclass	s.f.	ing.
master	s.m.	ing.
match	s.m.	ing.
matzá	s.f.	hebr.
matzeiva	s.f.	hebr.
maxwell	s.m.	ing.
mayday	s.m.	ing.
mazal	s.m.	hebr.
media	s.f.	ing.
médoc	s.m.	fr.
meeting	s.m.	ing.
megabit	s.m.	ing.
megabyte	s.m.	ing.
meme	s.m.	ing.
memorabilia	s.m.pl.	lat.
ménage	s.m.	fr.
menu	s.m.	fr.
merchandising	s.m.	ing.
mésalliance	s.f.	fr.
métier	s.m.	fr.
mezzosoprano	s.2g.	it.
mezzotinta	s.m.	it.
mi-carême	s.f.	fr.
microchip	s.m.	ing.
microlearning	s.m.	ing.
midrash	s.m.	hebr.
mignon	adj. s.m.	fr.
mignonne	adj. s.f.	fr.
mikado	s.m.	jap.
mike	s.m.	ing.
mikvá	s.f.	hebr.
milady	s.f.	ing.
milk-shake	s.m.	ing.
milord	s.m.	ing.
minbar	s.m.	ár.
mindfulness	s.m.	ing.
mindset	s.m.	ing.
minesänger	s.m.	al.
minhag	s.m.	hebr.
minian	s.m.	hebr.
mini-show	s.m.	ing.
mini-system	s.m.	ing.
minnesang	s.m.	al.
minnesinger	s.m.	al.
mise-en-plis	s.2g.2n.	fr.
mise-en-scène	s.f.	fr.
mise-en-train	s.f.	fr.
miserere	s.m.	lat.
missoshiro	s.m.	jap.
miss	s.f.	ing.
mister	s.m.	ing.
mistress	s.f.	ing.
mitzvá	s.f.	hebr.
mix	s.m.	ing.
mixtape	s.f.	ing.
modem	s.m.2n.	ing.
moderato	s.m.	it.
modus	s.m.	lat.
mohair	s.m.	ing.
mohel	s.m.	hebr.
moiré	s.m.	fr.
morbus	s.m.	lat.
morgan	s.m.	ing.
motocross	s.m.2n.	ing.
motu	s.m.	lat.
mouse	s.m.	ing.
mousse	s.f.	fr.
movietone	s.m.	ing.
mozzarella	s.f.	it.
muffin	s.m.	ing.
muguet	s.m.	fr.
multiplet	s.m.	ing.
multistandard	s.m.	ing.
musette	s.f.	fr.
music-hall	s.m.	ing.
naïf	adj. s.2g.	fr.
nebulium	s.m.	lat.
nécessaire	s.m.	fr.
nègre	s.m.	fr.
negroni	s.f.	it.
nerd	adj. s.2g.	ing.
net	s.f.	ing.
netsuke	s.m.	jap.
network	s.f.	ing.
new-look	s.m.2n.	ing.
newmarket	s.m.	ing.
newsletter	s.f.	ing.
nómos	s.m.	gr.
nonsense	adj.2g.	ing.
notebook	s.m.	ing.
nuance	s.f.	fr.
nude	s.m.	ing.
nurse	s.f.	ing.
nurture	s.f.	ing.
nylon	s.m.	ing.
off	adv.	ing.
office boy	s.m.	ing.
off-line	adv. adj.2g.2n.	ing.
offline	adv. adj.2g.2n.	ing.
offset	s.m.	ing.
offshore	adj.2g.2n.	ing.
offside	s.m.	ing.
okay	interj.	ing.
ok	interj. adj.2g.2n. adv. s.m.	ing.
ombudsman	s.m.	sue.
on-line	adv. adj.2g.2n.	ing.
online	adv. adj.2g.2n.	ing.
open bar	s.m.	ing.
opus	s.m.	lat.
organum	s.m.	lat.
origami	s.m.	jap.
orizuru	s.m.	jap.
ossobuco	s.m.	it.
ostinato	s.m.	it.
outboard	s.m.	ing.
outcaste	s.m.	ing.
outdoor	s.m.	ing.
outline	s.m.	ing.
output	s.m.	ing.
outrigger	s.m.	ing.
outsider	s.2g.	ing.
ouverture	s.f.	fr.
overall	s.m.	ing.
overblowing	s.m.	ing.
overbooking	s.m.	ing.
overdose	s.f.	ing.
overflow	s.m.	ing.
overhead	s.m.	ing.
overlay	s.m.	ing.
oxford	s.m.	ing.
paddock	s.m.	ing.
paella	s.f.	esp.
pager	s.m.	ing.
palmier	s.m.	fr.
panaché	s.m.	fr.
pandit	s.m.	sâns.
panneau	s.m.	fr.
panzer	s.m.f.	al.
paparazzi	s.m.pl.	it.
paparazzo	s.m.	it.
papier-mâché	s.m.	fr.
pappardelle	s.m.2n.	it.
pappus	s.m.	lat.
parking	s.m.	ing.
parkinson	s.m.	ing.
parkour	s.m.	fr.
parole	s.f.	fr.
parterre	s.f.	fr.
partisan	s.m.	fr.
parvenu	s.m.	fr.
pas-de-deux	s.m.	fr.
pas-de-quatre	s.m.	fr.
pasodoble	s.m.	esp.
passacaglia	s.f.	it.
passamezzo	s.m.	it.
passe-partout	s.m.2n.	fr.
passe-pied	s.m.2n.	fr.
passim	adv.	lat.
pastis	s.m.	fr.
pastrami	s.m.	ing.
patchwork	s.m.	ing.
pater	s.m.	lat.
páthos	s.m.2n.	gr.
patronnesse	s.f.	fr.
pattern	s.m.	ing.
paywall	s.m.	ing.
pecan	s.f.	ing.
pecorino	s.m.	it.
pedigree	s.m.	ing.
peeling	s.m.	ing.
peignoir	s.m.	fr.
pellet	s.m.	ing.
pembroke	s.m.	ing.
pendant	s.m.	fr.
pendentif	s.m.	fr.
penny	s.m.	ing.
peppermint	s.2g.	ing.
perfectum	s.m.	lat.
performance	s.f.	ing.
performer	s.2g.	ing.
personal trainer	s.2g.	ing.
pessach	s.m.	hebr.
petenera	s.f.	esp.
petit-beurre	s.m.	fr.
petit-four	s.m.	fr.
petit-pois	s.m.	fr.
petit-suisse	s.m.	fr.
pet shop	s.2g.	ing.
physique du rôle	s.m.	fr.
physis	s.f.	gr.
piadina	s.f.	it.
pianoforte	s.m.	it.
picardan	s.m.	fr.
pickles	s.m.pl.	ing.
pickup	s.m.	ing.
pidgin	s.m.	ing.
pièce-de-résistance	s.f.	fr.
pied-de-poule	s.m.	fr.
piercing	s.m.	ing.
pilotis	s.m.2n.	fr.
pince-nez	s.2g.	fr.
pinscher	s.2g.	al.
pinup	s.f.	ing.
pipeline	s.m.	ing.
pit-bull	s.m.	ing.
pitching	s.m.	ing.
pitch	s.m.	ing.
pixel	s.m.	ing.
pizzaiolo	s.m.	it.
pizza	s.f.	it.
pizzicato	s.m.	it.
placet	s.m.	lat.
plafonnier	s.m.	fr.
plaid	s.f.	ing.
plantation	s.f.	ing.
playback	s.m.	ing.
playboy	s.m.	ing.
playground	s.m.	ing.
playlist	s.2g.	ing.
play-off	s.m.	ing.
play	s.m.	ing.
plié	s.m.	fr.
plush	s.m.	ing.
pochade	s.f.	fr.
poché	adj.	fr.
podcast	s.m.	ing.
pogron	s.m.	iíd.
pointer	s.m.	ing.
poke	s.m.	ing.
pole-position	s.f. s.2g.	ing.
poltergeist	s.m.	al.
ponticello	s.m.	it.
poodle	s.m.	ing.
pool	s.m.	ing.
pop-up	s.m.	ing.
porte-bonheur	s.m.2n.	fr.
portland	s.m.	ing.
portoro	s.m.	it.
poseur	adj. s.m.	fr.
positronium	s.m.	ing.
positurae	s.f.pl.	lat.
poster	s.m.	ing.
post	s.m.	ing.
potin	s.m.	fr.
pot-pourri	s.m.	fr.
poundal	s.m.	ing.
pound	s.m.	ing.
première	s.f.	fr.
premier	s.m.	fr.
prêt-à-porter	adj.2g.2n. s.m.	fr.
primo	adv.	lat.
primum	adv.	lat.
prise	s.f.	fr.
pro forma	adv.adj.	lat.
pro labore	s.m.	lat.
promenade	s.f.	fr.
promoter	s.2g.	ing.
protus	s.m.	lat.
proxy	s.m.	ing.
pschent	s.m.	egíp.
publisher	s.2g.	ing.
pub	s.m.	ing.
pueblo	s.m.	esp.
puff	s.m.	ing.
pug	s.m.	ing.
pullman	s.m.	ing.
punch	s.m.	ing.
punk	adj. s.2g.	ing.
purée	s.f.	fr.
putsch	s.m.	al.
putter	s.m.	ing.
putting	s.m.	ing.
puttino	s.m.	it.
putto	s.m.	it.
putt	s.m.	ing.
puzzle	s.m.	ing.
quadrimomentum	s.m.	lat.
quadrivium	s.m.	lat.
quanta	s.m.pl.	lat.
quantum	s.m.	lat.
quarkonium	s.m.	ing.
quark	s.m.	ing.
quart	s.m.	ing.
queer	adj.2g.2n. s.2g.	ing.
quérable	adj.2g.	fr.
quiche	s.2g.	fr.
quid	s.m.	lat.
quiz	s.m.	ing.
quodlibet	s.m.	lat.
quorum	s.m.	lat.
raccord	s.m.	ing.
racing	s.m.	ing.
rack	s.m.	ing.
racle	s.f.	fr.
raclette	s.f.	fr.
radicchio	s.m.	it.
raffiné	adj.	fr.
rafting	s.m.	ing.
raglan	s.2g.2n.	ing.
ragtime	s.m.	ing.
raid	s.m.	ing.
railroad	s.m.	ing.
rail	s.m.	ing.
railway	s.m.	ing.
rallentando	adv.	it.
rallye	s.m.	ing.
ranking	s.m.	ing.
ranz	s.m.	al.
rapper	s.2g.	ing.
rapport	s.m.	fr.
rap	s.m.	ing.
rash	s.m.	ing.
raté	adj. s.m.	fr.
rattan	s.m.	ing.
raver	s.m.	ing.
rave	s.m.	ing.
ravigote	s.f.	fr.
ravióli	s.m.	it.
raygrass	s.m.	ing.
rayon	s.m.	ing.
reality-show	s.m.	ing.
reblochon	s.m.	fr.
reboot	s.m.	ing.
recall	s.m.	ing.
recamier	s.m.	fr.
receiver	s.m.	ing.
recepisse	s.m.	lat.
réchaud	s.m.	fr.
récit	s.m.	fr.
record	s.m.	ing.
referee	s.m.	ing.
referendum	s.m.	lat.
reggae	s.m.	ing.
reich	s.m.	al.
relais	s.m.2n.	fr.
relax	s.m.2n.	ing.
release	s.m.	ing.
remake	s.m.	ing.
rendez-vous	s.m.	fr.
rentrée	s.f.	fr.
replay	s.m.	ing.
repoussé	adj. s.m.	fr.
reps	s.m.	fr.
resort	s.m.	ing.
restaurateur	s.m.	fr.
rétro	adj.2g.2n. s.m.	fr.
réveillon	s.m.	fr.
revival	s.m.	ing.
rhazal	s.m.	ár.
riesling	s.m.	al.
ring	s.m.	ing.
rink	s.m.	ing.
ripieno	s.m.	it.
ritardando	adv. s.m.	it.
ritenuto	adj.	it.
rocaille	s.m.	fr.
rock-and-roll	s.m.	ing.
rock	s.m.	ing.
rollover	s.m.	ing.
romagnolo	s.m.	it.
roman-fleuve	s.m.	fr.
rooter	s.m.	ing.
roquefort	s.m.	fr.
rosé	adj. s.2g.	fr.
rôtisserie	s.f.	fr.
rougeot	s.m.	fr.
rouge	s.m.	fr.
rough	s.m.	ing.
roulade	s.f.	fr.
roulé	adj.	fr.
roulotté	s.m.	fr.
round	s.m.	ing.
roux	adj. s.m.2n.	fr.
royalty	s.m.	ing.
rubato	adj. s.m.	it.
rubber	s.m.	ing.
ruche	s.f.	fr.
rush	s.m.	ing.
sabaoth	s.m.pl.	lat.
samizdat	s.m.	rus.
sanctus	s.m.2n.	lat.
sans-culotte	adj. s.2g.	fr.
sashimi	s.m.	jap.
sauvignon	s.m.	fr.
savoir-faire	s.m.2n.	fr.
savoir-vivre	s.m.2n.	fr.
scanner	s.m.	ing.
scat	s.m.	ing.
schedule	s.m.	ing.
scherzando	adv.	it.
scherzo	s.m.	it.
schilling	s.m.	al.
scholar	s.m.	ing.
schottisch	s.m.	al.
sciolto	adj.	it.
scooter	s.m.	ing.
scordatura	s.f.	it.
scotch	s.m.	ing.
scout	s.m.	ing.
scrambler	s.m.	ing.
scraper	s.m.	ing.
script	s.m.	ing.
scuba	s.m.	ing.
sealed-beam	adj. s.m.	ing.
sedan	s.m.	ing.
selfie	s.f.	ing.
self-made man	s.m.	ing.
self-service	s.m.	ing.
self	s.m.	ing.
set	s.m.	ing.
setter	s.m.	ing.
settimino	s.m.	it.
sex appeal	s.m.	ing.
sexting	s.m.	ing.
sexy	adj.2g.2n.	ing.
shalom	s.m. interj.	hebr.
shamisen	s.f.	jap.
shampoo	s.m.	ing.
shareware	s.m.	ing.
sharpie	s.m.	ing.
sheik	s.m.	ing.
sheriff	s.m.	ing.
shiatsu	s.m.	jap.
shiitake	s.m.	jap.
shilling	s.m.	ing.
shimeji	s.m.	jap.
shimmy	s.m.	ing.
shopping center	s.m.	ing.
shortline	s.m.	ing.
short	s.m.	ing.
shot	s.m.	ing.
showbiz	s.m.	ing.
show business	s.m.	ing.
showcase	s.m.	ing.
showroom	s.m.	ing.
showrunner	s.2g.	ing.
show	s.m.	ing.
shoyu	s.m.	jap.
shunt	s.m.	ing.
sic	adv.	lat.
sidecar	s.m.	ing.
sir	s.m.	ing.
site	s.m.	ing.
sivan	s.m.	hebr.
skater	adj. s.2g.	ing.
skate	s.m.	ing.
skating	s.m.	ing.
sketch	s.m.	ing.
skinhead	s.2g.	ing.
slackline	s.m.	ing.
slack	s.m.	ing.
slalom	s.m.	nor.
slang	s.m.	ing.
slide	s.m.	ing.
sling	s.m.	ing.
slogan	s.m.	ing.
slow fashion	s.m.	ing.
slow food	s.m.	ing.
slut-shaming	s.m.	ing.
smartphone	s.m.	ing.
smash	s.m.	ing.
smoking	s.m.	ing.
smorzando	s.m. adv.	it.
snipe	s.m.	ing.
soave	s.m.	it.
socialite	s.2g.	ing.
softball	s.m.	ing.
software	s.m.	ing.
soi-disant	adj.2g.2n.	fr.
soirée	s.f.	fr.
sommelier	s.m.	fr.
sommier	s.m.	fr.
songbook	s.m.	ing.
sostenuto	adj.	it.
soubrette	s.f.	fr.
soul	s.m.	ing.
stabile	s.m.	lat.
staccato	s.m.	it.
staff	s.m.	ing.
stakeholder	s.m.	ing.
stalker	s.2g.	ing.
stalking	s.m.	ing.
standard	adj.2g.2n. s.m.	ing.
stand-by	adj.2g. s.m.	ing.
standing	adj.2g.2n. s.m.	ing.
stand	s.m.	ing.
stanhope	s.m.	ing.
starlet	s.f.	ing.
star	s.2g.	ing.
starter	s.m.	ing.
start-up	s.f.	ing.
startup	s.f.	ing.
statim	adv.	lat.
stator	s.m.	ing.
status	s.m.2n.	lat.
steak	s.m.	ing.
steeplechase	s.m.	ing.
stent	s.m.	ing.
step	s.m.	ing.
steward	s.m.	ing.
stick	s.m.	ing.
stokes	s.m.2n.	ing.
stonewashed	adj.2g.2n.	ing.
stop-and-go	adj.2g.2n.	ing.
stop	s.m.	ing.
store	s.m.	ing.
storyboard	s.m.	ing.
stout	s.f.	ing.
stracchino	s.m.	it.
strambotto	s.m.	it.
strass	s.m.2n.	fr.
streaming	s.m.	ing.
stress	s.m.	ing.
stretch	adj.2g.2n.	ing.
stretching	s.m.	ing.
stretta	s.f.	it.
stretto	s.m.	it.
striptease	s.m.	ing.
strogonoff	s.m.	rus.
strongman	s.m.	ing.
stud	s.m.	ing.
sudoku	s.m.	jap.
sukiyaki	s.m.	jap.
superavit	s.m.2n.	lat.
supply-side	adj.2g.2n. s.m.2n.	ing.
supra	adv.	lat.
surfing	s.m.	ing.
surf	s.m.	ing.
sursis	s.m.	fr.
sushi	s.m.	jap.
swab	s.m.	ing.
swap	s.m.	ing.
sweepstake	s.m.	ing.
swing	s.m.	ing.
tableau	s.m.	fr.
tablet	s.m.	ing.
tacet	s.m.	lat.
taco	s.m.	esp.
taekwondo	s.m.	cor.
tagliatelle	s.m.2n.	it.
tag	s.f.	ing.
tailleur	s.m.	fr.
take away	adj.2g.2n. s.m.	ing.
take out	adj.2g.2n. s.m.	ing.
talavera	s.2g.	esp.
tambourin	s.m.	fr.
tandem	s.m.	ing.
tanka	s.m.	jap.
taper	s.m.	ing.
tartare	s.m.	fr.
tartine	s.f.	fr.
tavolatura	s.f.	it.
taxi-girl	s.f.	ing.
tchernoziom	s.m.	rus.
tchervonets	s.m.2n.	rus.
teaser	adj. s.m.	ing.
teckel	s.2g.	al.
teenager	s.2g.	ing.
tee-shirt	s.f.	ing.
tee	s.m.	ing.
teflon	s.m.	ing.
telemarketing	s.m.	ing.
teleprompter	s.m.	ing.
template	s.m.	ing.
tenuta	s.f.	it.
tenuto	adj.	it.
terabite	s.m.	ing.
terabyte	s.m.	ing.
teriyaki	s.m.	jap.
terrier	s.m.	ing.
tertius	s.m.	lat.
test drive	s.m.	ing.
testudo	s.f.	lat.
tête-à-tête	s.m.	fr.
tête-bêche	adj. adv.	fr.
theotókos	s.f.	gr.
thesaurus	s.m.	lat.
thinner	s.m.	ing.
thriller	s.m.	ing.
ticket	s.m.	ing.
tie-dye	s.m.	ing.
timer	s.m.	ing.
time-sharing	s.m.	ing.
timing	s.m.	ing.
tiramisu	s.m.	it.
tishrei	s.m.	hebr.
toast	s.m.	ing.
toddy	s.m.	ing.
toffee	s.m.	ing.
tofu	s.m.	jap.
toilette	s.f.	fr.
token	s.m.	ing.
tomahawk	s.m.	ing.
tondero	s.m.	esp.
toner	s.m.	ing.
too	s.m.	ing.
topless	adj. s.2g.	ing.
tópos	s.m.	gr.
top	s.m.	ing.
torculus	s.m.	lat.
toreador	s.m.	esp.
tory	adj. s.2g.	ing.
touring	s.m.	ing.
tournedos	s.m.2n.	fr.
tournée	s.f.	fr.
tournure	s.f.	fr.
tour	s.m.	fr.
trader	s.2g.	ing.
trade	s.m.	ing.
trade-union	s.f.	ing.
trading	s.m.	ing.
trailer	s.m.	ing.
training	s.m.	ing.
train	s.m.	fr.
tramway	s.m.	ing.
tranche	s.f.	fr.
transfer	s.m.	ing.
trap	s.m.	ing.
trash	s.m.	ing.
trattoria	s.f.	it.
travelling	s.m.	ing.
treedozer	s.m.	ing.
trekking	s.m.	ing.
tremolo	s.m.	it.
trend	s.m.	ing.
trial	s.m.	ing.
tricinium	s.m.	lat.
trickline	s.m.	ing.
tricot	s.m.	fr.
trivium	s.m.	lat.
troika	s.f.	rus.
trolley	s.m.	ing.
trottoir	s.m.	fr.
troupe	s.f.	fr.
trousse	s.f.	fr.
trouvaille	s.f.	fr.
tsunami	s.m.	jap.
tsuru	s.m.	jap.
tuner	s.m.	ing.
turf	s.m.	ing.
turgor	s.m.	lat.
turnover	s.m.	ing.
tutti	s.m.pl.	it.
tutu	s.m.	fr.
tweed	s.m.	ing.
tweet	s.m.	ing.
twitter	s.m.	ing.
umami	s.m.	jap.
umlaut	s.m.	al.
underground	s.m. adj.2g.2n.	ing.
underwriting	s.m.	ing.
unschooling	s.m.	ing.
upgrade	s.m.	ing.
upload	s.m.	ing.
up-to-date	adj.2g.	ing.
valet	s.m.	ing.
van	s.f.	ing.
vaporwave	s.m.	ing.
vaudeville	s.m.	fr.
veduta	s.f.	it.
veilleuse	s.f.	fr.
veld	s.m.	hol.
vendeuse	s.f.	fr.
vermeil	adj.	fr.
vernier	s.m.	fr.
vernissage	s.m.	fr.
versus	prep.	lat.
vibrato	s.m.	it.
videobook	s.m.	ing.
video game	s.m.	ing.
videogame	s.m.	ing.
videolaser	s.m.	ing.
videomaker	s.m.	ing.
videowall	s.m.	ing.
vide	s.f.	lat.
viking	adj.2g.	ing.
vintage	adj.2g.2n. s.m.	ing.
violone	s.m.	it.
vis-à-vis	adj.2g. adv. prep.	fr.
vison	s.m.	fr.
vis	s.f.	lat.
vitaglass	s.m.	ing.
vitrine	s.f.	fr.
vivace	adv.2g.	it.
vocalise	s.m.	fr.
vocoder	s.m.	ing.
voile	s.2g.	fr.
vol-au-vent	s.m.	fr.
volleyball	s.m.	ing.
volley	s.m.	ing.
voucher	s.m.	ing.
voyeur	s.m.	fr.
wad	s.m.	ing.
waffle	s.m.	ing.
waiver	s.m.	ing.
wakashan	s.m.	ing.
walkie-talkie	s.m.	ing.
walkover	s.m.	ing.
warrant	s.m.	ing.
waterline	s.m.	ing.
webcam	s.f.	ing.
web designer	s.2g.	ing.
web design	s.m.	ing.
webinar	s.m.	ing.
webmaster	s.2g.	ing.
web	s.f.	ing.
week-end	s.m.	ing.
weltanschauung	s.f.	al.
western-blot	s.m.	ing.
western	s.m.	ing.
westpolitik	s.f.	al.
whig	adj. s.2g.	ing.
whiskey	s.m.	ing.
whisky	s.m.	ing.
wi-fi	adj.2g.2n. s.m.	ing.
winchester	s.m.f.	ing.
wireless	adj.2g.2n. s.m.	ing.
wombat	s.m.	ing.
workaholic	adj. s.2g.	ing.
workshop	s.m.	ing.
workstation	s.2g.	ing.
wow	s.m.	ing.
write-off	s.m.	ing.
yachting	s.m.	ing.
yachtsman	s.m.	ing.
yacht	s.m.	ing.
yaki-mono	s.m.	jap.
yakisoba	s.m.	jap.
yakuza	s.f.	jap.
yang	s.m.	chin.
yard	s.f.	ing.
yashiro	s.m.	jap.
yearling	s.m.	ing.
yen	s.m.	jap.
yeti	s.m.	tibet.
yin	s.m.	chin.
yin-yang	s.m.	chin.
yoga	s.2g.	sâns.
yorkshire-terrier	s.m.	ing.
youtuber	s.2g.	ing.
yuppie	adj. s.2g.	ing.
yurtzeit	s.m.	hebr.
yuzu	s.m.	jap.
zabaione	s.m.	it.
zamacueca	s.f.	esp.
zeitgeist	s.m.	al.
zeste	s.m.	fr.
zloty	s.m.	pol.
zoom	s.m.	ing.
